1111111111111
10010000000C1
10000111110001111
1P0011E0000000001
11111111111111111