1111121111111
1001C00000001
1000011111001
1P0011E000001
1111111111111