1111111111111
1PC1000000001
100C011111001
10C011E000001
1111111111111
