1111111111111
10C1C00000001
10C0011111001
1P0011E000001
1111111111111