1111111111111
10C1000000001
1000011111001
10P011E000001
1111111111111
