1111111111111
1PC1C00000001
10C0011111001
100011E000001
1111111111111
